1111111111
1P0000CC01
10110110E1
1010001111
1010100001
1000111101
1010000101
1001101001
1000001001
1111111111
