111111111
10000P011
100000001
10C00E011
111111111