1111111111111111111111
1000P00000000000000001
1000001001011110000001
1000001001000010000001
10000011110111100C0001
1000C0000101000E000001
1000000001011110000001
1000000000000000000001
1111111111111111111111